border_size=1
usage=map

Mm          , Mm          , Mm^Xm       , Mm          , Mm          , Mm          , Mm          , Mm          , Mm          , Mm          , Hh^Fp       , Hh^Fp       , Hh^Fp       , Hh^Fp       , Hh^Fmf      , Hh^Fmf      , Hh^Fmf      , Rd          , Gs^Fp       , Gs^Fp       , Gs^Fmf      , Gs^Fp       , Gs^Fp       , Gs^Fp       , Gs^Fp       , Gs^Fp       , Gs^Fp       , Gs^Fp       , Gs^Fp       , Gs^Fp       , Gs^Fdf      , Gs^Fdf      , Gs^Fdf      , Gs^Fdf      , Gs^Fdf      , Gs^Fdf      , Gs^Fdf      , Gs^Fdf      , Gs^Fdf      , Rd          , Gs^Fmf      , Gs^Fdf      , Gs^Fdf      , Gs^Fdf      , Gs^Fdf      , Gs^Fdf      , Gs^Fmf      , Gs^Fdf      , Gs^Fdf      , Gs^Fdf      , Wo          , Wo          , Wo          , Wo          
Mm          , Mm          , Mm          , Mm          , Mm          , Mm          , Aa^Vea      , Mm          , Mm          , Mm          , Hh^Fp       , Hh^Fp       , Hh^Fp       , Hh^Fp       , Hh^Fmf      , Hh          , Rd          , Rd          , Gs^Fmf      , Gs^Fp       , Gs^Fp       , Gs^Fmf      , Gs^Fp       , Gs^Fp       , Gs^Fp       , Gs^Fp       , Gs^Fmf      , Gs^Fmf      , Gs^Fmf      , Gs^Fp       , Gs^Fp       , Gs^Fmf      , Gs^Fmf      , Gs^Fdf      , Gs^Fdf      , Gs^Fdf      , Gs^Fdf      , Gs^Fdf      , Rd          , Rd          , Gs^Fmf      , Gs^Fmf      , Gs^Fdf      , Gs^Fdf      , Gs^Fdf      , Gs^Fdf      , Gs^Fdf      , Gs^Fdf      , Ww          , Ww          , Ww^Vm       , Wo          , Gs^Fdf      , Gs^Fdf      
Mm          , Mm          , Ai          , Mm          , Mm          , Mm          , Mm          , Mm          , Hh^Fp       , Hh^Fp       , Hh^Fp       , Hh^Fp       , Hh          , Hh^Fmf      , Re          , Rd          , Re^Vct      , Gs^Fp       , Re^Vct      , Gs^Fmf      , Gs^Fp       , Gs^Fmf      , Hh^Fp       , Gs^Fp       , Gs^Fmf      , Hh^Fdf      , Gs^Fdf      , Gs^Fdf      , Gs^Fp       , Gs^Fp       , Gs^Fp       , Gs^Fp       , Gs^Fp       , Gs^Fmf      , Gs^Fdf      , Gs^Fdf      , Rd          , Rd          , Rd          , Gs^Fmf      , Gs^Fmf      , Gs^Fmf      , Gs^Fmf      , Gs^Fmf      , Gs^Fmf      , Gs^Fdf      , Ww          , Ww          , Ww          , Ww          , Gs^Fdf      , Gs^Fdf      , Gs^Fdf      , Gs^Fdf      
Ms          , Ms          , Ai          , Ww          , Ww^Vm       , Mm          , Hh^Fp       , Hh^Fp       , Hh^Fp       , Hh^Fp       , Hh^Fdw      , Hh^Fdw      , Ce          , Ce          , Ce          , Rd          , Gs^Fmf      , Gs^Fmf      , Gs^Fp       , Gs^Fmf      , Gs^Fmf      , Gs^Fmf      , Chr         , Gg^Ve       , Hh^Fdf      , Gs^Fdf      , Gs^Fdf      , Gs^Fmf      , Gs^Fp       , Gs^Fp       , Gs^Fp       , Gs^Fp       , Gs^Fmf      , Gs^Fmf      , Gs^Fdf      , Gs^Fdf      , Rd          , Gs^Fdf      , Rd          , Gs^Fmf      , Gs^Fmf      , Gs^Fmf      , Ss          , Gg          , Ggf         , Hh^Fmf      , Ww          , Ww          , Gs^Fp       , Gs^Fmf      , Gs^Fmf      , Gs^Fdf      , Gs^Fdf      , Gs^Fdf      
Ms          , Ms          , Ms          , Ai          , Mm          , Ww          , Ww          , Hh^Fmf      , Hh^Fmf      , Hh^Fmf      , Hh^Fdw      , Hh^Fdw      , Ce          , 1 Ke        , Ce          , Rd          , Gs^Fp       , Gs^Fp       , Ggf         , Gg          , Ggf         , Rp          , Hh^Fp       , Gs^Fmf      , Gs^Fp       , Hh^Fdf      , Gs^Fp       , Gs^Fp       , Gs^Fp       , Gs^Fp       , Gs^Fmf      , Gs^Fmf      , Gs^Fp       , Gs^Fdf      , Gs^Fdf      , Gs^Fmf      , Rd          , Gs^Fdf      , Gs^Fp       , Rd          , Rd          , Gs^Fmf      , Ss          , Ss          , Wwf         , Ww          , Wwf         , Hh^Fmf      , Gs^Fdf      , Gs^Fdf      , Gs^Fdf      , Gs^Fdf      , Gs^Fdf      , Gs^Fdf      
Ms          , Ms          , Ms          , Ms          , Mm          , Hh^Fp       , Ww          , Mm          , Ww          , Hh^Fmf      , Gs^Fmf      , Hh^Fdw      , Gs^Fmf      , Ce          , Re          , Rd          , Rd          , Gs^Fp       , Ww          , Wwf         , Wwf         , Gs^Fp       , Gs^Fp       , Gs^Fp       , Ww          , Gs^Fmf      , Gs^Fdf      , Gs^Fmf      , Gs^Fmf      , Gs^Fmf      , Gs^Fmf      , Gs^Fmf      , Rd          , Rd          , Rd          , Rd          , Gs^Fmf      , Gs^Fdf      , Gs^Fmf      , Gs^Fdf      , Gs^Fdf      , Rd          , Rd          , Wwf         , Ww          , Wwf         , Ggf         , Ggf         , Gs^Fdf      , Gs^Fdf      , Gs^Fdf      , Gs^Fdf      , Gs^Fdf      , Gs^Fdf      
Ms          , Ms          , Ms          , Mm          , Hh^Fp       , Hh^Fp       , Hh^Fdf      , Ww          , Hh^Fmf      , Ww          , Ww          , Gs^Fp       , Wwf         , Gs^Fmf      , Re          , Re^Vct      , Re          , Wwf^Bw\     , Rd          , Ggf         , Ww          , Gs^Fp       , Ww          , Ww          , Gs^Fdf      , Ww          , Ww          , Gs^Fmf      , Gs^Fdf      , Gs^Fmf      , Chs         , Rd          , Gs^Fdf      , Gs^Fdf      , Gs^Fmf      , Gs^Fmf      , Gs^Fmf      , Gs^Fmf      , Gs^Fdf      , Gs^Fdf      , Gs^Fdf      , Gs^Fdf      , Ww^Vm       , Ww^Bw\      , Rd          , Ggf         , Gs^Fdf      , Gs^Fdf      , Gs^Fmf      , Gs^Fdf      , Gs^Fmf      , Gs^Fmf      , Gs^Fdf      , Gs^Fdf      
Mm          , Mm          , Mm          , Mm          , Mm          , Hh^Fp       , Hh          , Hh^Fdf      , Hh^Fmf      , Gs^Fp       , Gs^Fmf      , Wwf         , Re          , Ww          , Wwf         , Re          , Wwf         , Wwf         , Rd          , Gs^Fp       , Gs^Fmf      , Wwf         , Gs^Fdf      , Gs^Fmf      , Gs^Fdf      , Gs^Fmf      , Gs^Fmf      , Ww          , Ww^Bw/      , Rd          , Wwf         , Ss^Vm       , Gs^Fdf      , Gs^Fdf      , Gs^Fp       , Gs^Fmf      , Gs^Fmf      , Gs^Fmf      , Gs^Fmf      , Gs^Fdf      , Gs^Fdf      , Hh^Fmf      , Ww          , Wwf         , Gg          , Rd          , Gg^Vl       , Gs^Fdf      , Gs^Fdf      , Gs^Fdf      , Gs^Fp       , Gs^Fmf      , Rd          , Rd          
Ms          , Mm          , Mm          , Mm          , Hh^Fp       , Hh^Fp       , Mm          , Hh          , Hh^Fmf      , Gs^Fp       , Gs^Fmf      , Gs^Fmf      , Gs^Fmf      , Rd          , Gs          , Ww          , Ggf         , Gs^Fp       , Ggf         , Rd          , Rd          , Gs^Fdf      , Rd          , Gs^Fdf      , Gs^Fmf      , Hh^Fmf      , Rd          , Rd          , Ggf         , Wwf         , Ww          , Wwf         , Ww          , Gs^Fdf      , Gs^Fmf      , Gs^Fmf      , Gs^Fdf      , Gs^Fdf      , Gs^Fdf      , Gs^Fdf      , Wwf         , Ww          , Hh^Fdf      , Hh^Fdf      , Uu^Uf       , Gs^Fp       , Gs^Fmf      , Rd          , Rd          , Rd          , Rd          , Rd          , Gs^Fp       , Gs^Fdf      
Ms          , Mm          , Mm          , Mm          , Hh          , Hh          , Hh          , Hh^Fp       , Hh^Fmf      , Gs^Fp       , Gs^Fmf      , Gs^Fp       , Gs^Fp       , Rd          , Gs^Fp       , Ggf         , Gs^Fp       , Gs^Fp       , Gs^Fmf      , Gs^Fmf      , Gs^Fdf      , Rd          , Gs^Fmf      , Rd          , Rd          , Rd          , Hh^Fdf      , Hh^Fdf      , Ww          , Ww          , Gs^Fdf      , Gs^Fp       , Gs^Fmf      , Ww          , Ww          , Ww          , Ww          , Gs^Fdf      , Ww          , Gs^Fmf      , Ww          , Wwf         , Ggf         , Gs^Fdf      , Gs^Fdf      , Gs^Fdf      , Gs^Fdf      , Hh^Fmf      , Hh^Fmf      , Gs^Fdf      , Gs^Fmf      , Gs^Fp       , Gs^Fdf      , Gs^Fdf      
Ms          , Ms          , Aa^Vha      , Mm          , Mm          , Hh^Fp       , Hh          , Hh          , Hh          , Hh^Fp       , Hh^Fp       , Hh          , Hh^Fmf      , Rd          , Hh^Fmf      , Gs^Fp       , Hh^Fp       , Gs^Fp       , Gs^Fmf      , Gs^Fmf      , Gs^Fdf      , Gs^Fmf      , Gs^Fdf      , Gs^Fdf      , Gs^Fmf      , Rd          , Ww^Bw\      , Ww          , Gs^Fdf      , Gs^Fdf      , Gs^Fmf      , Gs^Fmf      , Hh^Fdf      , Gs^Fdf      , Gs^Fmf      , Gs^Fdf      , Gs^Fmf      , Ww          , Ww          , Ww          , Ww          , Ggf         , Gs^Fmf      , Gs^Fmf      , Gs^Fdf      , Gs^Fdf      , Gs^Fp       , Gs^Fmf      , Mm          , Hh^Fdf      , Hh^Fdf      , Gs^Fmf      , Gs^Fdf      , Gs^Fdf      
Ms          , Mm          , Mm          , 2 Khr       , Chr         , Hh          , Hh          , Hh          , Hh^Fp       , Mm          , Ww          , Ww          , Ww          , Rd          , Gs^Fmf      , Hh^Fmf      , Hh^Fp       , Gs^Fp       , Gs^Fmf      , Gs^Fdf      , Gs^Fmf      , Gs^Fdf      , Gs^Fdf      , Gs^Fdf      , Gs^Fdf      , Wwf         , Wwf         , Rd          , Rd          , Hh^Fdf      , Hh          , Hh^Fdf      , Hh^Vo       , Gs^Fdf      , Gs^Fdf      , Gs^Fdf      , Gs^Fmf      , Gs^Fmf      , Ss          , Ww^Vm       , Ww          , Gs^Fp       , Gs^Fmf      , Gs^Fdf      , Gs^Fdf      , Gs^Fdf      , Mm          , Mm          , Mm          , Mm          , Hh^Fp       , Hh^Fmf      , Gs^Fdf      , Gs^Fdf      
Mm          , Mm          , Mm          , Mm          , Hh          , Hh          , Hh          , Hh          , Gs^Fp       , Hh          , Gs^Fp       , Gs^Fp       , Rd          , Wwf         , Ww          , Hh^Fmf      , Hh^Fp       , Hh^Fp       , Hh^Fp       , Gs^Fmf      , Gs^Fdf      , Gs^Fdf      , Gs^Fdf      , Gs^Fdf      , Ww          , Ww          , Gs^Fmf      , Gs^Fp       , Rd          , Hh^Fdf      , Hh^Fmf      , Hh          , Hh^Fmf      , Hh^Fdf      , Gs^Fdf      , Gs^Fmf      , Rd          , Rd          , Gs^Fmf      , Gs^Fp       , Gs^Fmf      , Wwf         , Wwf         , Gs^Fdf      , Gs^Fdf      , Gs^Fdf      , Gs^Fdf      , Mm          , Mm          , Hh          , Hh^Fdf      , Hh^Fmf      , Gs^Fdf      , Gs^Fdf      
Ms          , Mm          , Mm          , Mm          , Mm          , Hh          , Hh          , Gs^Fp       , Gs^Fp       , Gs^Fp       , Rd          , Rd          , Gs^Fp       , Gs^Fp       , Gs^Fp       , Ww          , Ww          , Wwf         , Ww          , Gs^Fp       , Ww^Vm       , Gs^Fmf      , Ww          , Ww          , Gs^Fmf      , Gs^Fmf      , Hh^Fdf      , Gs^Fdf      , Rd          , Hh^Fp       , Wwf         , Hh^Fmf      , Gs^Fdf      , Gs^Fdf      , Rd          , Rd          , Gs^Fmf      , Gs^Fdf      , Gs^Fmf      , Gs^Fmf      , Gs^Fdf      , Wwf         , Wwf         , Gs^Fdf      , Gs^Fmf      , Gs^Fdf      , Gs^Fdf      , Hh^Fdf      , Hh^Fdf      , Hh^Fdf      , Gs^Fdf      , Gs^Fdf      , Gs^Fdf      , Gs^Fdf      
Ms          , Ms          , Ms          , Mm          , Mm          , Mm          , Hh          , Gs^Fp       , Gs^Fp       , Gs^Fp       , Rd          , Hh^Fp       , Hh^Fp       , Hh^Fp       , Hh^Fp       , Hh^Fp       , Hh^Fp       , Gs^Fp       , Gs^Fp       , Ww          , Ww          , Ww          , Gs^Fp       , Gs^Fmf      , Gs^Fp       , Hh^Fdf      , Hh^Fdf      , Hh^Fdf      , Rd          , Gg^Vl       , Gg          , Hh^Fmf      , Rd          , Rd          , Hh^Fdf      , Hh^Fdf      , Gs^Fmf      , Gs^Fmf      , Gs^Fp       , Gs^Fmf      , Gs^Fdf      , Gs^Fdf      , Gs^Fmf      , Ww          , Ww          , Ww          , Ww          , Gs^Fdf      , Gs^Fdf      , Gs^Fmf      , Gs^Fmf      , Gs^Fdf      , Gs^Fdf      , Gs^Fdf      
Ms          , Ms          , Ms          , Mm          , Mm          , Mm          , Hh^Fp       , Hh^Fmf      , Hh^Fp       , Gs^Fp       , Hh^Fp       , Rd          , Hh^Fp       , Hh^Fp       , Hh^Fmf      , Hh^Fp       , Hh^Fp       , Hh^Fp       , Gs^Fp       , Ww          , Gs^Fp       , Gs^Fmf      , Gs^Fdf      , Gs^Fmf      , Gs^Fmf      , Hh^Fdf      , Gs^Fp       , Hh^Fdf      , Rd          , Gg          , Rd          , Rd          , Gs^Fmf      , Hh^Fdf      , Hh^Fdf      , Gs^Fp       , Gs^Fp       , Gs^Fmf      , Gs^Fmf      , Gs^Fp       , Gs^Fmf      , Gs^Fmf      , Gs^Fmf      , Ww          , Wo          , Wo          , Wo          , Ww^Vm       , Gs^Fmf      , Gs^Fp       , Gs^Fmf      , Gs^Fdf      , Gs^Fdf      , Gs^Fdf      
Ms          , Ms          , Ms          , Mm          , Hh^Fp       , Hh^Fp       , Hh^Fp       , Hh          , Hh          , Hh^Fmf      , Rd          , Rd          , Hh^Fmf      , Hh^Fp       , Ggf         , Gs^Fp       , Ggf         , Gs^Fp       , Ww          , Ww          , Gs^Fmf      , Gs^Fmf      , Gs^Fdf      , Gs^Fdf      , Gs^Fmf      , Gs^Fp       , Gs^Fp       , Gg^Vh       , Gs^Fp       , Rd          , Rd          , Gs^Fmf      , Gs^Fp       , Gs^Fp       , Gs^Fmf      , Gs^Fmf      , Rd          , Gs^Fp       , Re          , Gs^Fmf      , Gs^Fdf      , Gs^Fmf      , Ss          , Ww          , Wo          , Wo          , Wo          , Ww          , Ww          , Gs^Fmf      , Gs^Fdf      , Gs^Fdf      , Gs^Fdf      , Gs^Fdf      
Ms          , Ms          , Mm          , Aa^Vla      , Hh^Fp       , Hh^Fp       , Hh^Fmf      , Hh          , Hh^Fmf      , Hh^Fmf      , Rd          , Gs^Fp       , Gs^Fp       , Gs^Fp       , Gs^Fp       , Gs^Fp       , Gs^Fmf      , Ww          , Gs^Fmf      , Gs^Fmf      , Gs^Fdf      , Gs^Fdf      , Gs^Fmf      , Gs^Fmf      , Gs^Fmf      , Gs^Fmf      , Gs^Fmf      , Gs^Fp       , Rd          , Rd          , Gs^Fp       , Rd          , Rd          , Rd          , Rd          , Rd          , Gs^Fdf      , Rd          , Ww^Bw|      , Re          , Ss          , Ss^Vm       , Ww          , Ww          , Ww          , Wo          , Ww          , Ww          , Gs^Fdf      , Gs^Fdf      , Gs^Fdf      , Gs^Fdf      , Gs^Fmf      , Gs^Fdf      
Mm          , Mm          , Mm          , Mm          , Mm          , Chr         , Hh^Fmf      , Hh^Fmf      , Hh^Fmf      , Hh          , Rd          , Gs^Fp       , Gs^Fp       , Gs^Fp       , Gs^Fp       , Gs^Fp       , Ww          , Ww          , Gs^Fmf      , Gs^Fmf      , Gs^Fmf      , Gs^Fmf      , Ggf         , Gs^Fmf      , Gs^Fmf      , Hh^Fdf      , Rd          , Rd          , Gs^Fdf      , Gs^Fmf      , Gs^Fmf      , Gs^Fmf      , Gs^Fmf      , Gs^Fmf      , Gs^Fdf      , Gs^Fmf      , Ww          , Ww          , Ss^Bw|      , Wwf         , Ww          , Ss          , Ww          , Gs^Fmf      , Gs^Fdf      , Ww          , Gs^Fmf      , Gs^Fdf      , Gs^Fdf      , Gs^Fdf      , Gg^Fet      , Gs^Fdf      , Gs^Fdf      , Gs^Fmf      
Ms          , Ms          , Ai          , Mm          , Mm          , Hh^Fp       , Hh          , Hh          , Hh          , Hh^Fmf      , Hh          , Rd          , Rd          , Gs^Fmf      , Gs^Fmf      , Wwf         , Gs^Fmf      , Gs^Fmf      , Gs^Fmf      , Gs^Fmf      , Gs^Fmf      , Gs^Fmf      , Gs^Fmf      , Gs^Fmf      , Gs^Fdf      , Gs^Fdf      , Rd          , Gs^Fmf      , Gs^Fdf      , Gs^Fmf      , Gs^Fdf      , Gs^Fdf      , Hh^Fmf      , Hh^Fmf      , Mm          , Ww          , Hh^Fmf      , Gs^Fdf      , Rd          , Gs^Fp       , Gs^Fdf      , Ww          , Gs^Fdf      , Gs^Fdf      , Gs^Fdf      , Gs^Fmf      , Gs^Fmf      , Gs^Fdf      , Kv          , Cv          , Gs^Fmf      , Gs^Fdf      , Gs^Fdf      , Gs^Fdf      
Ms          , Ai          , Ww          , Mm          , Mm          , Hh^Fp       , Hh^Fmf      , Hh^Fmf      , Hh^Fmf      , Hh          , Hh          , Hh^Fmf      , Rd          , Gs^Fmf      , Ww          , Ww          , Gs^Fmf      , Gs^Fmf      , Gs^Fp       , Gs^Fdf      , Mm          , Hh^Fdf      , Gs^Fmf      , Gs^Fdf      , Gs^Fdf      , Rd          , Gs^Fdf      , Gs^Fdf      , Gs^Fdf      , Gs^Fdf      , Gs^Fdf      , Gs^Fdf      , Hh          , Mm          , Mm          , Mm          , Mm          , Gs^Fmf      , Rd          , Gs^Fmf      , Gs^Fdf      , Gs^Fdf      , Gs^Fmf      , Gs^Fdf      , Gs^Fdf      , Gs^Fdf      , Cv          , Kv          , 3 Kv        , Cv          , Gs^Fmf      , Gs^Fmf      , Gs^Fdf      , Gs^Fdf      
Mm          , Ms          , Ms          , Ww          , Ww          , Hh^Fp       , Hh^Fp       , Hh^Fmf      , Hh          , Hh          , Hh          , Hh^Fmf      , Rd          , Ggf         , Wwf         , Gs^Fmf      , Gs^Fmf      , Gs^Fmf      , Hh^Fdf      , Hh^Fdf      , Hh          , Mm          , Hh^Fdf      , Hh^Fdf      , Gs^Fdf      , Rd          , Gs^Fmf      , Gs^Fdf      , Gs^Fdf      , Gs^Fdf      , Gs^Fmf      , Gs^Fdf      , Gs^Fdf      , Hh^Fp       , Hh^Fmf      , Mm          , Hh^Fmf      , Rd          , Gs^Fmf      , Gs^Fdf      , Gs^Fdf      , Gs^Fdf      , Gs^Fdf      , Gs^Fdf      , Gs^Fdf      , Gs^Fmf      , Gs^Fmf      , Cv          , Cv          , Cv          , Gs^Fmf      , Gs^Fdf      , Gs^Fdf      , Gs^Fdf      
Ms          , Mm          , Mm          , Aa^Vea      , Mm          , Ww          , Ww          , Wwf         , Ww          , Hh^Fmf      , Wwf         , Hh^Fmf      , Ww          , Wwf         , Gs^Fp       , Gs^Fp       , Hh^Fp       , Hh^Fp       , Hh^Fdf      , Hh^Fdf      , Gg^Ve       , Hh^Fdf      , Gs^Fmf      , Gs^Fdf      , Gs^Fmf      , Rd          , Gs^Fdf      , Gs^Fdf      , Gs^Fmf      , Gs^Fp       , Gs^Fdf      , Gs^Fdf      , Gs^Fmf      , Gs^Fdf      , Gs^Fdf      , Gs^Fdf      , Rd          , Rd          , Gs^Fmf      , Gs^Fmf      , Gs^Fmf      , Gs^Fp       , Gs^Fmf      , Gs^Fmf      , Gs^Fdf      , Gs^Fp       , Gs^Fdf      , Gs^Fdf      , Gg^Fet      , Gs^Fmf      , Gs^Fdf      , Gg^Fet      , Gs^Fmf      , Gs^Fdf      
Ms          , Ms          , Ms          , Mm          , Mm          , Mm          , Hh          , Hh^Fp       , Hh^Fp       , Ww          , Hh          , Ww          , Ww^Vm       , Ww          , Gs^Fp       , Hh^Fp       , Gs^Fmf      , Hh^Fp       , Gs^Fmf      , Ww          , Ww          , Gg^Ve       , Gs^Fdf      , Gs^Fdf      , Gs^Fmf      , Rd          , Gs^Fdf      , Gs^Fdf      , Gs^Fdf      , Gs^Fmf      , Gs^Fdf      , Gs^Fmf      , Gs^Fdf      , Gs^Fdf      , Gs^Fdf      , Gs^Fdf      , Rd          , Gs^Fdf      , Gs^Fmf      , Gs^Fmf      , Gs^Fp       , Gs^Fp       , Gs^Fp       , Gs^Fmf      , Gg^Ve       , Gs^Fdf      , Gs^Fdf      , Gg^Fet      , Gs^Fmf      , Gs^Fdf      , Gs^Fdf      , Gg^Ve       , Gs^Fdf      , Gs^Fdf      
Ms          , Ms          , Ms          , Ms          , Ms          , Mm          , Hh          , Hh          , Hh          , Hh^Fp       , Gs^Fmf      , Gs^Fmf      , Gs^Fmf      , Rd          , Gs^Fmf      , Gs^Fmf      , Gs^Fmf      , Gs^Fmf      , Gs^Fmf      , Gs^Fmf      , Gs^Fmf      , Gs^Fp       , Gs^Fmf      , Gs^Fmf      , Gs^Fdf      , Rd          , Gs^Fdf      , Gs^Fdf      , Gs^Fdf      , Gs^Fdf      , Gs^Fdf      , Gs^Fdf      , Gs^Fdf      , Gs^Fdf      , Rd          , Rd          , Gs^Fdf      , Gs^Fdf      , Gs^Fdf      , Gs^Fmf      , Gs^Fdf      , Gs^Fdf      , Gs^Fdf      , Gs^Fdf      , Gs^Fdf      , Gs^Fdf      , Gs^Fdf      , Gs^Fdf      , Gs^Fdf      , Gs^Fmf      , Gs^Fdf      , Gs^Fdf      , Gs^Fdf      , Gs^Fdf      
