border_size=1
usage=map

Hh^Fp       , Hh^Fp       , Hh          , Hh          , Hh          , Hh          , Mm          , Mm          , Mm          , Mm          , Mm          , Mm          , Mm          , Mm          , Mm          , Mm          , Mm          , Ms          , Mm          , Ms          , Ai          , Ms          , Mm          , Ai          , Mm          , Mm          , Mm          , Ms          , Mm          , Ms          , Mm          , Ms          , Mm          , Ms          , Mm          , Mm          , Hh          , Hh          , Hh          , Hh          , Hh          
Hh^Fmf      , Hh^Fmf      , Hh          , Hh          , Mm          , Ww          , Hh          , Mm          , Hh          , Hh          , Mm          , Mm          , Mm          , Mm          , Mm          , Mm          , Mm          , Mm          , Mm          , Ai          , Ai          , Mm          , Mm          , Mm          , Mm          , Mm          , Mm          , Mm          , Mm          , Mm          , Mm          , Mm          , Mm          , Mm          , Hh          , Hh^Vo       , Hh          , Hh          , Hh^Fp       , Hh^Fp       , Hh^Fp       
Gg          , Hh          , Hh          , Hh^Vc       , Mm          , Hh          , Mm          , Hh          , Hh^Fp       , Hh          , Hh          , Mm          , Hh^Fp       , Hh^Fp       , Mm^Vhh      , Mm          , Mm          , Mm          , Mm          , Mm          , Mm          , Ai          , Ww          , Mm          , Mm          , Mm          , Mm          , Mm          , Hh          , Mm          , Mm          , Hh          , Hh          , Hh          , Hh          , Hh          , Hh          , Hh          , Hh          , Hh^Fp       , Hh^Fp       
Gg          , Gg          , Hh          , Hh          , Mm          , Mm          , Mm          , Hh          , Hh          , Hh^Fp       , Hh          , Mm          , Hh^Fp       , Hh^Fp       , Mm          , Mm          , Mm          , Mm          , Mm          , Mm          , Mm          , Mm          , Mm          , Ww          , Ww          , Mm          , Mm          , Mm          , Mm          , Mm          , Hh          , Mm          , Hh          , Hh          , Hh          , Hh^Fp       , Hh^Fp       , Hh^Fp       , Gg          , Hh          , Gs^Fp       
Gg          , Gg          , Gg          , Hh          , Gg          , Ww          , Hh^Fp       , Hh^Fp       , Mm          , Hh          , Hh          , Mm          , Mm          , Mm          , Mm          , Mm          , Mm          , Mm          , Mm          , Mm          , Mm          , Mm          , Mm          , Mm          , Mm          , Ww          , Ww          , Mm          , Hh          , Hh          , Hh          , Hh          , Mm          , Mm          , Hh          , Hh          , Hh^Fp       , Hh^Fp       , Gg          , Gs^Fp       , Rd          
Gg          , Gg          , Gg          , Gg          , Gg          , Ww          , Gg          , Hh^Fp       , Gg          , Hh^Fp       , Hh          , Hh          , Hh          , Mm          , Mm          , Mm          , Mm          , Mm          , Hh          , Hh^Fp       , Mm          , Mm          , Mm          , Mm^Vhh      , Mm          , Mm          , Hh          , Ww          , Ww          , Mm          , Hh          , Hh          , Hh          , Mm          , Hh^Fp       , Hh^Fp       , Hh          , Hh          , Gg          , Rd          , Gg          
Gg          , Gg          , Gg          , Gg          , Gg          , Ww          , Ww          , Gg          , Ww          , Gg          , Mm          , Hh          , Ww          , Ww          , Ww          , Ww          , Ww          , Mm          , Mm          , Hh          , Mm          , Mm          , Mm          , Mm          , Hh^Fp       , Hh^Fp       , Hh          , Mm          , Ww          , Ggf         , Hh          , Hh          , Hh          , Hh^Fp       , Hh^Fp       , Hh^Fp       , Gg          , Gg          , Rd          , Rd          , Gg          
Hh          , Gg          , Gg          , Gg          , Gg          , Gg          , Ww          , Ww          , Gg          , Ww          , Ww          , Ww          , Ggf         , Ggf         , Hh          , Hh          , Hh          , Mm^Vc       , Hh          , Mm          , Hh          , Mm          , Hh          , Hh^Fp       , Hh^Fp       , Hh^Fp       , Ggf         , Mm          , Ww          , Ggf         , Hh          , Hh^Vc       , Hh^Fp       , Hh^Fp       , Gs^Fp       , Gs^Fp       , Gg          , Gg          , Rd          , Rd          , Gg          
Hh^Fmf      , Hh^Fmf      , Hh^Fmf      , Gs^Fdf      , Gg          , Ww          , Gg          , Gg          , Hh^Fp       , Gg          , Ggf         , Ggf         , Mm          , Mm          , Hh          , Hh          , Hh          , Hh          , Hh          , Hh          , Hh^Fp       , Hh          , Mm          , Hh          , Hh          , Ggf         , Ww          , Ww          , Ggf         , Ggf         , Hh^Fp       , Hh          , Gg          , Gs^Fp       , Gs^Fp       , Gg          , Gg          , Rd          , Rd          , Gg          , Gg          
Hh^Fp       , Hh^Fmf      , Hh^Fp       , Gs^Fdf      , Gg          , Ww          , Re          , Hh^Vo       , Hh          , Hh^Fp       , Hh^Fp       , Hh          , Hh^Fp       , Mm          , Mm          , Hh          , Hh          , Hh          , Hh          , Hh^Fp       , Hh^Fp       , Mm          , Mm          , Mm          , Hh          , Gg          , Ww          , Gg          , Hh^Fmf      , Hh          , Gg          , Gg          , Gg          , Gs^Fp       , Gg          , Gg          , Ce          , Ce          , Ce          , Gg          , Gg          
Hh          , Hh^Fmf      , Hh^Fmf      , Hh^Fmf      , Rd          , Ww^Bw/      , Ww          , Gg          , Gg          , Hh^Fp       , Hh          , Hh^Fp       , Hh^Fp       , Hh^Fp       , Mm          , Mm          , Hh^Fp       , Gg          , Hh          , Hh          , Mm          , Mm          , Mm          , Mm          , Hh^Fp       , Gg          , Ww          , Gg          , Gg          , Gs^Fdf      , Gg          , Gg          , Gg          , Gg          , Gg          , Gg          , Ce          , 1 Ke        , Ce          , Gg          , Gg          
Hh^Fp       , Hh^Fp       , Hh^Fmf      , Gs^Fdf      , Rd          , Gg          , Ww          , Ww          , Gg          , Gg          , Gg          , Hh          , Hh          , Hh^Fp       , Hh^Fp       , Hh^Fp       , Hh^Fmf      , Gg          , Gg          , Hh          , Hh^Vhh      , Hh^Fp       , Hh^Fp       , Hh^Fp       , Hh^Fmf      , Gg          , Gg          , Ww          , Ww          , Gg          , Gg          , Gg          , Gg          , Gg          , Re^Vct      , Re          , Re          , Ce          , Re          , Gg          , Gg          
Hh^Fp       , Hh^Fp       , Hh          , Hh          , Rd          , Gg          , Gg          , Ww          , Gg          , Gg          , Gg          , Gg          , Gg          , Gg          , Gg          , Hh^Fmf      , Gs^Fdf      , Hh^Fmf      , Gg          , Hh          , Hh          , Hh          , Gs^Fp       , Gs^Fp       , Gs^Fdf      , Gs^Fdf      , Gg          , Gg          , Gg          , Ww          , Gg          , Gg          , Gg          , Gg          , Gg          , Re          , Rd          , Re          , Re^Vct      , Re^Vct      , Gg          
Gg          , Hh^Vc       , Gg          , Hh          , Rd          , Gg          , Gg          , Ww          , Ww          , Gg          , Gg          , Gg          , Gg          , Gg          , Gg          , Gg          , Gg          , Gg          , Gg          , Gg          , Gg          , Gg          , Gg          , Gg          , Ww          , Gg          , Gg          , Gg          , Gg          , Ww          , Gg          , Gg          , Gg          , Gg          , Gg          , Gg          , Rd          , Rd          , Gg          , Gg          , Gg          
Gg          , Gg          , Gg          , Gg          , Rd          , Gg          , Gg          , Gg          , Gg          , Ww          , Ss          , Gg          , Gg          , Hh          , Gs^Fp       , Hh^Fdf      , Hh^Fdf      , Gg          , Gg          , Gg          , Gg          , Gg          , Ww          , Ww          , Gg          , Ww          , Ww          , Gg          , Ww          , Ww          , Gg          , Gg          , Gg          , Gg          , Gg          , Rd          , Rd          , Gg          , Gg          , Gg          , Gg          
Gg          , Gg          , Gg          , Gg          , Rd          , Gg          , Gg          , Gg          , Gg          , Ww          , Ss^Vm       , Ss          , Hh          , Hh          , Hh          , Hh^Fdf      , Gg          , Gg          , Gg          , Gg          , Gg          , Gg          , Ww          , Gg          , Gg          , Gg          , Gg          , Ww          , Gg          , Gg          , Gg          , Gg          , Gg          , Gg          , Rd          , Rd          , Gg          , Gg          , Gg          , Gg          , Gg          
Gg          , Gg          , Gg          , Gg          , Rd          , Gg          , Gg          , Gg          , Gg          , Ss          , Gg          , Gg          , Gg          , Hh          , Gg          , Gg          , Gg          , Gg          , Gg          , Gg          , Gg          , Ww          , Ww^Vm       , Ww          , Gg          , Gg          , Gg          , Gg          , Gg          , Gg          , Gg          , Gg          , Gg          , Gg          , Rd          , Rd          , Gg          , Gg          , Gg          , Gg          , Gg          
Rd          , Rd          , Rd          , Rd          , Rd          , Gg          , Gg          , Gg          , Gg          , Gg          , Gg          , Gg          , Gg          , Gg          , Gg          , Gg          , Gg          , Gg          , Gg          , Gg          , Gg          , Ww          , Ww          , Gg          , Gg          , Gs^Fdf      , Gs^Fdf      , Gg          , Gg          , Gg          , Gg          , Gg          , Rd          , Rd          , Gg          , Gg          , Gg          , Gg          , Gg          , Gg          , Gg          
Rd          , Rd          , Gg          , Rd          , Rd          , Rd          , Rd          , Rd          , Rd          , Rd          , Rd          , Rd          , Rd          , Rd          , Rd          , Gg          , Gg          , Gg          , Gg          , Gg          , Gg          , Gg          , Gg          , Gg          , Gg          , Gg          , Gg          , Gg          , Gg          , Gg          , Gg          , Rd          , Rd          , Rd          , Gg          , Gg          , Gg          , Gg          , Gg          , Gg          , Gg          
Gg          , Gg          , Gg          , Gg          , Gg          , Gg          , Gg          , Rd          , Gg          , Rd          , Rd          , Rd          , Gg          , Rd          , Rd          , Rd          , Rd          , Rd          , Rd          , Gg          , Gg          , Gg          , Gg          , Gg          , Gg          , Gg          , Gg          , Gg          , Gg          , Gg          , Rd          , Rd          , Gg          , Gg          , Gg          , Gg          , Gg          , Gg          , Gg          , Gg          , Gg          
Gs^Fdf      , Gg          , Gg          , Gg          , Gg          , Gg          , Gg          , Gg          , Gg          , Gg          , Gg          , Gg          , Gg          , Gg          , Gg          , Rd          , Gg          , Rd          , Rd          , Rd          , Rd          , Rd          , Rd          , Gg          , Rd          , Gg          , Rd          , Rd          , Rd          , Rd          , Gg          , Gg          , Gg          , Gg          , Gg          , Gg          , Gg          , Gg          , Gg          , Gg          , Gg          
Gs^Fmf      , Gs^Fmf      , Gg          , Gg          , Gg          , Gs^Fdf      , Gs^Fmf      , Gg          , Gg          , Gg          , Gg          , Gg          , Gg          , Gg          , Hh          , Hh          , Hh          , Gg          , Gg          , Hh^Fp       , Hh^Fp       , Rd          , Rd          , Rd          , Rd          , Rd          , Rd          , Rd          , Gg          , Gg          , Gg          , Gg          , Gg          , Gg          , Gg          , Gg          , Gg          , Gg          , Gg          , Gg          , Gg          
Gg          , Gg          , Gg          , Gg          , Gg          , Gg          , Gg          , Gs^Fp       , Gg          , Gg          , Gg          , Gg          , Hh          , Hh          , Mm          , Mm          , Mm          , Hh^Fp       , Hh^Fp       , Gg          , Gg          , Gg          , Gg          , Rd          , Rd          , Rd          , Gs^Fmf      , Gg          , Gg          , Gg          , Gs^Fdf      , Gg          , Gg          , Gg          , Gg          , Gg          , Gg          , Gg          , Gg          , Gg          , Gg          
Gg          , Gg          , Gg          , Gg          , Gg          , Gg          , Gg          , Gg          , Gg          , Gg          , Gg          , Gg          , Gg          , Hh^Fp       , Mm          , Mm          , Mm^Vc       , Mm          , Hh^Fp       , Gg          , Gg          , Gg          , Gg          , Rd          , Rd          , Gs^Fmf      , Hh^Fdf      , Gg          , Gs^Fmf      , Gs^Fdf      , Gg          , Gg          , Gg          , Gg          , Gg          , Gg          , Gg          , Gg          , Gg          , Gg          , Gg          
Gg          , Gg          , Gg          , Gg          , Gg          , Gg          , Gg          , Gg          , Gg          , Gg          , Gg          , Gg          , Gg          , Hh^Fp       , Hh^Fmf      , Mm          , Mm          , Ww          , Ww          , Gg          , Gg          , Gg          , Gg          , Rd          , Rd          , Gs^Fmf      , Gs^Fdf      , Gg          , Gg          , Gs^Fdf      , Gg          , Gg          , Gg          , Gg          , Gg          , Gg          , Gg          , Gg          , Gg          , Gg          , Gg          
Gg          , Gg          , Gg          , Gg          , Gg          , Gg          , Gg          , Gg          , Gg          , Gg          , Gg          , Gg          , Gg          , Gg          , Gs^Fdf      , Hh^Fmf      , Gg          , Hh          , Gg          , Ww          , Ww          , Gg          , Gg          , Rd          , Rd          , Gs^Fdf      , Gs^Fp       , Gs^Fmf      , Gg          , Gg          , Gg          , Gg          , Gg          , Gg          , Hh^Fp       , Gg^Ve       , Gg          , Gg          , Gg          , Gg          , Gg          
Gg          , Gg          , Gg          , Gg          , Gg          , Gg          , Gg          , Gg          , Gg          , Gg          , Gg          , Gg          , Gg          , Gg          , Gg          , Gg          , Gg          , Gg          , Ss          , Ww          , Ss          , Ss          , Rd          , Rd          , Rd          , Rd          , Rd          , Gg          , Gg          , Gg          , Gg          , Gg          , Gs^Fdf      , Hh^Fdf      , Mm          , Hh^Fp       , Hh          , Gg          , Gg          , Gg          , Gg          
Gg          , Gg          , Gg          , Gg          , Gg          , Gg          , Gg          , Gg          , Gg          , Gg          , Gg          , Gg          , Gg          , Gg          , Gg          , Gg          , Gg          , Gg          , Gg          , Ss          , Gg          , Gg          , Rd          , Rd          , Hh^Fdf      , Rd          , Rd          , Rd          , Rd          , Gg          , Gg          , Gg          , Gg          , Hh^Fmf      , Hh^Fp       , Mm          , Hh          , Hh          , Gg          , Gg          , Gg          
Gg          , Gg          , Gg          , Gg          , Gg          , Gg          , Gg          , Gs^Fdf      , Gg^Ve       , Gs^Fp       , Gs^Fdf      , Gg          , Gg          , Gg          , Gg          , Gg          , Rd          , Gg          , Rd          , Gg          , Rd          , Rd          , Gg          , Gs^Fmf      , Gs^Fmf      , Hh^Fmf      , Gg          , Rd          , Rd          , Rd          , Rd          , Gg          , Gg          , Gg          , Gg          , Hh          , Gg          , Hh          , Gg          , Gg          , Gg          
Gg          , Gg          , Gg          , Gg          , Gg          , Gg          , Gg          , Gs^Fdf      , Gs^Fdf      , Gs^Fmf      , Gs^Fdf      , Gg          , Gg          , Gg          , Rd          , Rd          , Rd          , Rd          , Gg          , Rd          , Gg          , Gg          , Gg          , Gg          , Gg          , Gg          , Gg          , Gg          , Gg          , Rd          , Rd          , Rd          , Rd          , Gg          , Gg          , Gg          , Gg          , Gg          , Gg          , Gg          , Gg          
Gs^Fdf      , Gg          , Gs^Fdf      , Gg          , Gg          , Gg          , Gg          , Gs^Fdf      , Gs^Fmf      , Gs^Fp       , Gg          , Gg          , Rd          , Rd          , Gg          , Gg          , Rd          , Gg          , Gg          , Gg          , Gg          , Gg          , Gg          , Gg          , Gg          , Gg          , Gg          , Gg          , Gg          , Gg          , Gg          , Rd          , Rd          , Rd          , Gg          , Gg          , Gg          , Gg          , Gg          , Gg          , Gg          
Gs^Fdf      , Gs^Fmf      , Gs^Fdf      , Gg          , Gg          , Gg          , Gg          , Gg          , Gs^Fp       , Gs^Fp       , Rd          , Rd          , Hh^Fp       , Gg          , Gg          , Gg          , Rd          , Gg          , Gg          , Gg          , Gg          , Gg          , Gg          , Gg          , Gg          , Gg          , Ww          , Ww          , Ww          , Gg          , Gg          , Gg          , Rd          , Rd          , Rd          , Gg          , Gg          , Gg          , Gg          , Gg          , Gs^Fmf      
Gg          , Gs^Fdf      , Gg^Vl       , Gg          , Gg          , Gg          , Gg          , Gg          , Gg          , Rd          , Gg          , Gg          , Hh^Fdf      , Hh          , Gg          , Rd          , Gg          , Gg          , Gg          , Gg          , Gg          , Gg          , Gg          , Gg          , Gg          , Ww          , Ww          , Ww          , Ww          , Gg          , Gg          , Gg          , Gg          , Rd          , Rd          , Rd          , Rd          , Gg          , Rd          , Gg          , Gs^Fmf      
Gg          , Gg          , Gg          , Gg          , Gg          , Gg          , Gg          , Gg          , Rd          , Rd          , Gg          , Gg          , Hh^Fp       , Hh^Fp       , Gg^Vc       , Rd          , Gg^Ve       , Gg          , Gg          , Gg          , Gg          , Gg          , Gg          , Gg          , Gg          , Gg          , Gg          , Ww          , Gg          , Gg          , Gg          , Gg          , Gg          , Gg          , Gg          , Rd          , Rd          , Rd          , Rd          , Rd          , Rd          
Gg          , Gg          , Gg          , Gg          , Gg          , Gg          , Rd          , Rd          , Gg          , Gg          , Hh^Fp       , Hh^Fp       , Hh^Fp       , Gg          , Gg          , Rd          , Gg          , Gg          , Hh^Fmf      , Hh^Fdf      , Hh^Fp       , Hh^Fp       , Hh          , Gg          , Gg          , Gg          , Gg          , Ww          , Ww          , Gg          , Gg          , Gg          , Gg          , Gg          , Hh^Fp       , Gg          , Gg          , Gg          , Gg          , Rd          , Rd          
Gg          , Gg          , Gg          , Gg          , Ce          , Ce          , Rd          , Gg          , Gg          , Gg          , Hh^Fp       , Hh^Fp       , Gg          , Gg          , Gg          , Gg          , Gg          , Hh^Fp       , Hh          , Hh^Fp       , Hh^Fp       , Hh^Fp       , Hh^Fmf      , Hh          , Hh^Fmf      , Hh^Fmf      , Hh^Fp       , Gg          , Ww          , Gg          , Hh^Fmf      , Hh^Fp       , Hh^Fp       , Hh^Fp       , Hh^Fp       , Hh          , Gg          , Gg          , Gg          , Gg          , Gg          
Gg          , Gg          , Gg          , Gg          , Ce          , Ce^Kov      , Ce          , Gg          , Hh^Fp       , Hh          , Mm          , Mm          , Hh          , Gg          , Gg          , Gg          , Hh^Fp       , Hh          , Hh^Vc       , Hh          , Mm          , Hh^Fp       , Hh^Fp       , Hh^Fp       , Hh          , Hh^Fp       , Hh^Fmf      , Gg          , Ww          , Gg          , Gg          , Hh^Fp       , Mm          , Mm          , Mm          , Hh^Fp       , Hh          , Gg          , Hh          , Gg          , Gg          
Gg          , Gg          , Gg          , Gg          , Rd          , 2 Ce        , Ce          , Hh          , Hh          , Mm          , Mm          , Mm          , Gg          , Gg          , Ww          , Gg          , Gg          , Hh          , Hh          , Mm          , Mm          , Mm          , Hh^Vo       , Hh^Fp       , Hh          , Hh          , Hh          , Gg          , Gg          , Ww          , Ww          , Gg          , Ww          , Mm          , Mm          , Mm          , Hh          , Hh^Fp       , Hh          , Hh          , Gg          
Gg          , Gg          , Rd          , Rd          , Gg          , Ce          , Gg          , Hh^Fp       , Gg          , Hh          , Hh^Fp       , Hh^Fp       , Gg          , Gg          , Gg          , Ww          , Gg          , Hh          , Hh          , Mm          , Mm          , Mm          , Mm          , Hh          , Hh          , Hh^Fp       , Hh          , Hh          , Mm          , Gg          , Gg          , Ww^Vm       , Hh          , Mm          , Mm          , Mm          , Hh^Fp       , Hh^Fp       , Hh          , Hh^Fp       , Hh          
Rd          , Rd          , Gg          , Gg          , Gg          , Gg          , Gg          , Gg          , Gg          , Gg          , Gg          , Gg          , Hh^Fp       , Hh^Fp       , Hh^Fp       , Ww          , Hh          , Hh^Fp       , Hh          , Hh          , Hh          , Hh          , Ai          , Mm          , Mm          , Hh          , Mm          , Mm          , Mm          , Mm          , Hh          , Ww          , Hh          , Mm          , Hh          , Hh          , Hh          , Hh          , Mm          , Hh          , Hh          
Gg          , Gg          , Gg          , Gg          , Gg          , Gs^Fdf      , Gs^Fdf      , Gg          , Gg          , Hh^Fp       , Hh^Fp       , Hh^Vhh      , Hh^Fp       , Hh^Fp       , Hh          , Ww          , Hh          , Hh          , Mm          , Mm          , Mm          , Ai          , Ai          , Mm          , Mm          , Mm          , Mm          , Mm          , Mm          , Mm          , Hh^Fp       , Ww          , Hh          , Mm          , Hh^Fp       , Hh^Vhh      , Mm          , Mm          , Mm          , Mm          , Mm          
Gg          , Gg          , Hh          , Gg          , Hh          , Hh^Fdf      , Hh^Fmf      , Hh          , Gg          , Gg          , Hh          , Hh          , Hh          , Hh          , Hh          , Ww          , Mm          , Mm          , Mm          , Mm          , Mm          , Ai          , Ai          , Mm          , Mm          , Mm          , Mm          , Mm          , Mm          , Mm          , Ww          , Ww          , Hh          , Hh          , Hh          , Hh^Fp       , Mm          , Mm          , Mm          , Mm          , Mm          
Hh          , Hh^Fp       , Hh^Fp       , Hh^Vo       , Hh^Fp       , Hh          , Hh          , Hh^Fp       , Hh          , Gg          , Hh          , Hh^Fp       , Hh          , Mm          , Mm          , Ww          , Mm          , Mm          , Mm          , Mm          , Mm          , Mm          , Mm          , Mm          , Mm          , Mm          , Mm          , Mm          , Mm          , Mm          , Mm          , Mm          , Mm          , Mm          , Mm          , Mm          , Mm          , Mm          , Mm          , Mm          , Mm          
Hh^Fp       , Hh^Fp       , Hh          , Hh          , Hh          , Mm          , Mm          , Hh          , Mm          , Hh          , Mm          , Hh          , Mm          , Mm          , Mm          , Mm          , Mm          , Mm          , Mm^Xm       , Mm^Xm       , Mm^Xm       , Mm          , Mm          , Mm          , Mm^Vc       , Mm          , Mm          , Mm          , Mm          , Mm          , Mm          , Mm          , Mm          , Mm          , Mm          , Mm          , Mm          , Mm          , Mm          , Mm          , Mm          
Hh^Fp       , Hh^Fp       , Hh          , Hh          , Mm          , Mm          , Mm          , Mm          , Mm          , Mm          , Mm          , Mm          , Mm          , Mm          , Mm^Xm       , Mm^Xm       , Mm^Xm       , Mm^Xm       , Mm^Xm       , Mm^Xm       , Mm^Xm       , Mm^Xm       , Mm^Xm       , Mm^Xm       , Mm^Xm       , Mm          , Mm          , Mm          , Mm          , Mm          , Mm          , Mm          , Mm          , Mm          , Mm          , Mm          , Mm          , Mm          , Mm          , Mm          , Mm          
